WWWWWWWWWWWWWWWWWWWWWW
W P     W     W     W
W WWW W WWWWW W W W W
W   W W   W   W W W W
WWW W WWW W WWW W W W
W   W W   W   W   W W
W W WWWWWWWWWWWWWWW W
W W    EC     W   W W
W WWWWW WWWWW W W W W
W   W         W   W W
WWW W WWWWWWW WWWWW W
W     W        C  W W
W WWW WWWWWWWWW W W W
W   W     E   W W W W
WWWWWWWWWWWGWWwWWWWWW
