WWWWWWWWWWWWWWWWWWWWWWWWWWWWWWWWW
W P   W     W   W       W      W
W W W W WWW W W W WWWWWWWWWWW  W
W W W W   W W W W W           W
W W WWWWWWW W W WWWWWWWWWWWWWWW
W W       W W   W       W     W
W WWWWWWW W WWWWW WWWWWWWWW W W
W   W     W     W W       W W W
W W W WWWWWWWWW W W WWWWW W W W
W W W   C     W   W     W W W W
W WWWWWWWWWWW WWWWWWWWWWW W W W
W     W   C     W   E C  W W WW
W WWWWW WWWWWWW W WWWWWWW W W W
W W   W     W   W  W     W   WW
W W W WWWWW W WWW WWWWWWWWWWW W
W W W W     W       W        WW
W WWW W     W      E   C   G WW
WWWWWWWWWWWWWWWWWWWWWWWWWWWWWWWW
