WWWWWWWWWWWWW
W P     C   W
W WWWWWWWWW W
W   C W  E  W
W WWW W WWW W
W   W   W   W
WWWWWWGWWWWWW
