WWWWWWWWWWWWWWWWWWWWWWWWWWWWW
W P     W   W          W CG W
W WWWWW W W WWWWW WWWWWW WWWW
W W   WCW W W     W         W
W W W W W W W W   W W WWWWWWW
W W W W W W W W   W    E    W
W W W W WWW W W   W WWWWWW WW
W W W     W W W   W C W E   W
W WWWWWWW WWW W WWWWWWWWWWW W
W   W  E  W   W    E  W     W
WWW W WWWWWWWWWWWWWWW W WW  W
W   W   W       W           W
W WWWWW W WWWWW W WWWWW WWWWW
W W   W W W   W W           W
W W   W     W W W   W    W  W
W WWWWWWWWW W W WWWWWW WWW WW
W         W     C    E   W GW
WWWWWWWWWWWWWWWWWWWWWWWWWWWWW
