WWWWWWWWWWWWW
W P  C    E W
W WWWWWWWWW W
W     W  C  W
W WWW W WWW W
W   W    E  W
WWWWWWGWWWWWW
